{
"tile_size": 32,
"map": [
"WWWWWWWWWWWWWWWWWWWW",
"WGGGGGGGGGGGGGGGGGGG",
"WGGGGGGGGGGGGGGGGGGG",
"WPPPPPPPPPPPPPPPPPPP",
"WPPPPPPPPPPPPPPPPPPP",
"WPPPPPPPPPPPPPPPPPPP",
"WGGGGGGGGGGGGGGGGGGG",
"WGGGGGGGGGGGGGGGGGGG",
"WGGGGGGGGGGGGGGGGGGG",
"WGGGGGGGGGGGGGGGGGGG",
"WGGGGGGGGGGGGGGGGGGG",
"WGGGGGGGGGGGGGGGGGGG",
"WGGGGGGGGGGGGGGGGGGG",
"WGGGGGGGGGGGGGGGGGGG",
"WGGGGGGGGGGGGGGGGGGG",
"WGGGGGGGGGGGGGGGGGGG",
"WGGGGGGGGGGGGGGGGGGG",
"WGGGGGGGGGGGGGGGGGGG",
"WGGGGGGGGGGGGGGGGGGG",
"WGGGGGGGGGGGGGGGGGGG",
"WGGGGGGGGGGGGGGGGGGG",
"WGGGGGGGGGGGGGGGGGGG",
"WGGGGGGGGGGGGGGGGGGG",
"WGGGGGGGGGGGGGGGGGGG"
]
}