{
    "tile_size": 32,
    "map": [
        "WWWWWWWWWWWWWWWWWWWW",
        "OGGGGGGGGGGGGGGGGGGG",
        "OGGGGGGGGGGGGGGGGGGG",
        "OPPPPPPPPPPPPPPPPPPP",
        "OPPPPPPPPPPPPPPPPPPP",
        "OPPPPPPPPPPPPPPPPPPP",
        "OGGGGGGGGGGGGGGGGGGG",
        "OGGGGGGGGGGGGGGGGGGG",
        "WWWWWWWWWWWWWWWWWWWW",
        "GGGGGGGGGGGGGGGGGGGG",
        "GGGGGGGGGGGGGGGGGGGG",
        "GGGGGGGGGGGGGGGGGGGG",
        "GGGGGGGGGGGGGGGGGGGG",
        "GGGGGGGGGGGGGGGGGGGG",
        "GGGGGGGGGGGGGGGGGGGG",
        "GGGGGGGGGGGGGGGGGGGG",
        "GGGGGGGGGGGGGGGGGGGG",
        "GGGGGGGGGGGGGGGGGGGG",
        "GGGGGGGGGGGGGGGGGGGG",
        "GGGGGGGGGGGGGGGGGGGG",
        "GGGGGGGGGGGGGGGGGGGG",
        "GGGGGGGGGGGGGGGGGGGG",
        "GGGGGGGGGGGGGGGGGGGG",
        "GGGGGGGGGGGGGGGGGGGG"
    ]
}