{
    "tile_size": 32,
    "map": [
        "WWWWWWWWWWWWWWWWWWWW",
        "tGGGtGGGtGGGtGGGtGGG",
        "TGGGTGGGTGGGTGGGTGGG",
        "PPPPPPPPPPPPPPPPPPPP",
        "PPPPPPPPPPPPPPPPPPPP",
        "PPPPPPPPPPPPPPPPPPPP",
        "GGtGGGtGGGtGGGtGGGtG",
        "GGTGGGTGGGTGGGTGGGTG",
        "WWWWWWWWWWWWWWWWWWWW",
        "GGGGGGGGGGGGGGGGGGGG",
        "GGGGGGGGGGGGGGGGGGGG",
        "GGGGGGGGGGGGGGGGGGGG",
        "GGGGGGGGGGGGGGGGGGGG",
        "GGGGGGGGGGGGGGGGGGGG",
        "GGGGGGGGGGGGGGGGGGGG",
        "GGGGGGGGGGGGGGGGGGGG",
        "GGGGGGGGGGGGGGGGGGGG",
        "GGGGGGGGGGGGGGGGGGGG",
        "GGGGGGGGGGGGGGGGGGGG",
        "GGGGGGGGGGGGGGGGGGGG",
        "GGGGGGGGGGGGGGGGGGGG",
        "GGGGGGGGGGGGGGGGGGGG",
        "GGGGGGGGGGGGGGGGGGGG",
        "GGGGGGGGGGGGGGGGGGGG"
    ]
}