{
    "tile_size": 32,
    "map": [
        "WWWWWWWWWWWWWWWWWWWW",
        "tGtGtGtGtGtGtGtGtGtG",
        "TGTGTGTGTGTGTGTGTGTG",
        "PPPPPPPPPPPPPPPPPPPP",
        "PPPPPPPPPPPPPPPPPPPP",
        "PPPPPPPPPPPPPPPPPPPP",
        "GtGtGtGtGtGtGtGtGtGt",
        "GTGTGTGTGTGTGTGTGTGT",
        "WWWWWWWWWWWWWWWWWWWW",
        "GGGGGGGGGGGGGGGGGGGG",
        "GGGGGGGGGGGGGGGGGGGG",
        "GGGGGGGGGGGGGGGGGGGG",
        "GGGGGGGGGGGGGGGGGGGG",
        "GGGGGGGGGGGGGGGGGGGG",
        "GGGGGGGGGGGGGGGGGGGG",
        "GGGGGGGGGGGGGGGGGGGG",
        "GGGGGGGGGGGGGGGGGGGG",
        "GGGGGGGGGGGGGGGGGGGG",
        "GGGGGGGGGGGGGGGGGGGG",
        "GGGGGGGGGGGGGGGGGGGG",
        "GGGGGGGGGGGGGGGGGGGG",
        "GGGGGGGGGGGGGGGGGGGG",
        "GGGGGGGGGGGGGGGGGGGG",
        "GGGGGGGGGGGGGGGGGGGG"
    ]
}