{
    "tile_size": 32,
    "map": [
        "WGGGGGGGGGGGGGGPPPGW",
        "WGGGGGGGGGGGGGGPPPGW",
        "WGGGGGGtGGGGGGGPPPGW",
        "WGGGGGGTGGGGGGGPPPGW",
        "WGGGGGGGGGGGGGGPPPGW",
        "WGGGGGGGGGGtGGGPPPGW",
        "WGGGGGGGGGGTGGGPPPGW",
        "WGGGGGGGGGGGGGGPPPGW",
        "WGGGGGGGGGGGGGGPPPGW",
        "WGGGGGGGGtGGGGGPPPGW",
        "WGGGGGGGGTGGGGGPPPGW",
        "WGGGGGGGGGGGGGGPPPGW",
        "WGGGGGGGGGGGtGGPPPGW",
        "WGGGGGGGGGGGTGGPPPGW",
        "WGGtGGGGGGGGGGGPPPGW",
        "WGGTGGGGGGGGGGGPPPGW",
        "WGGGGGGGGGGGGGGPPPGW",
        "WGGGGGGGGtGGGGGPPPGW",
        "WGGGGGGGGTGGGGGPPPGW",
        "WGGGGGGGGGGGGGGPPPGW",
        "WGGGtGGGGGGGGGGPPPGW",
        "WGGGTGGGGGGGGtGPPPGW",
        "WGGGGGGGGGGGGTGPPPGW",
        "WGGGGGGGGGGGGGGPPPGW"
    ]
}