{
    "tile_size": 32,
    "map": [
        "WWWWWWWWWWWWWWOOOOOW",
        "tGtGtGtGtGtGtGtPPPtW",
        "TGTGTGTGTGTGTGTPPPTW",
        "PPPPPPPPPPPPPPPPPPGW",
        "PPPPPPPPPPPPPPPPPPtW",
        "PPPPPPPPPPPPPPPPPPTW",
        "GtGtGtGtGtGtGtGPPPGW",
        "GTGTGTGTGTGTGTGPPPGW",
        "WWWWWWWWWWWWWWWPPPWW",
        "WGGGGGGGGGGGGGGPPPGW",
        "WGGGGGGtGGGGGGGPPPGW",
        "WGGGGGGTGGGGGGGPPPGW",
        "WGGGGGGGGGGGGGGPPPGW",
        "WGGGtGGGGGGGGGGPPPGW",
        "WGGGTGGGGGGtGGGPPPGW",
        "WGGGGGGGGGGTGGGPPPGW",
        "WGGGGGGGGGGGGGGPPPGW",
        "WGGGGGGGGGGGGGGPPPGW",
        "WGGGGGtGGGGGtGGPPPGW",
        "WGGGGGTGGGGGTGGPPPGW",
        "WGGGGGGGGGGGGGGPPPGW",
        "WGtGGGGGGGGGGGGPPPGW",
        "WGTGGGGGGGtGGGGPPPGW",
        "WGGGGGGGGGTGGGGPPPGW"
    ]
}