{
    "tile_size": 32,
    "map": [
        "WWWWWWWWWWWWWWWWWWWW",
        "GGGGGGGGGGGGGGGGGGGG",
        "GGGGGGGGABCDEFGGGGGG",
        "GGGGGGGGHIJKLMGGGGGG",
        "GGGGGGGGNQRSUVGGGGGG",
        "GGGGGGGGXYZ0$%GGGGGG",
        "GGGGGGGG123456GGGGGG",
        "GGGGGGGG789!@#GGGGGG",
        "GGGGGGGGGGGGGGGGGGGG",
        "PPPPPPPPPPPPPPPPPPPP",
        "PPPPPPPPPPPPPPPPPPPP",
        "PPPPPPPPPPPPPPPPPPPP",
        "GGPPPGGGGGGGGGGGGGGG",
        "GGPPPGGGABCDEFGGGGGG",
        "GGPPPGGGHIJKLMGGGGGG",
        "GGPPPGGGNQRSUVGGGGGG",
        "GGPPPGGGXYZ0$%GGGGGG",
        "GGPPPGGG123456GGGGGG",
        "GGPPPGGG789!@#GGGGGG",
        "PPPPPPPPPPPPPPPPPPPP",
        "PPPPPPPPPPPPPPPPPPPP",
        "PPPPPPPPPPPPPPPPPPPP",
        "GGGGGGGGGGGGGGGGGGGG",
        "WWWWWWWWWWWWWWWWWWWW"
    ]
}