{
    "tile_size": 32,
    "map": [
        "WWWWWWWWWWWWWWWWWWWW",
        "WGGGGGGGGGGGGGGGGGGG",
        "WGGGGGGGABCDEFGGGGGG",
        "WGGGGGGGHIJKLMGGGGGG",
        "WGGGGGGGNQRSUVGGGGGG",
        "WGGGGGGGXYZ0$%GGGGGG",
        "WGGGGGGG123456GGGGGG",
        "WGGGGGGG789!@#GGGGGG",
        "WGGGGGGGGGGGGGGGGGGG",
        "WGPPPPPPPPPPPPPPPPPP",
        "WGPPPPPPPPPPPPPPPPPP",
        "WGPPPPPPPPPPPPPPPPPP",
        "WGPPPGGGGGGGGGGGGGGG",
        "WGPPPGGGABCDEFGGGGGG",
        "WGPPPGGGHIJKLMGGGGGG",
        "WGPPPGGGNQRSUVGGGGGG",
        "WGPPPGGGXYZ0$%GGGGGG",
        "WGPPPGGG123456GGGGGG",
        "WGPPPGGG789!@#GGGGGG",
        "PPPPPPPPPPPPPPPPPPPP",
        "PPPPPPPPPPPPPPPPPPPP",
        "PPPPPPPPPPPPPPPPPPPP",
        "WGGGGGGGGGGGGGGGGGGG",
        "WWWWWWWWWWWWWWWWWWWW"
    ]
}