{
"tile_size": 32,
"map": [
"WWWWWWWWWWWWWWWWWWWW",
"GGGGGGGGGGGGGGGGGGGG",
"GGGGGGGGGGGGGGGGGGGG",
"PPPPPPPPPPPPPPPPPPPP",
"PPPPPPPPPPPPPPPPPPPP",
"PPPPPPPPPPPPPPPPPPPP",
"GGGGGGGGGGGGGGGGGGGG",
"GGGGGGGGGGGGGGGGGGGG",
"GGGGGGGGGGGGGGGGGGGW",
"GGGGGGGGGGGGGGGGGGGW",
"GGGGGGGGGGGGGGGGGGGW",
"GGGGGGGGGGGGGGGGGGGW",
"GGGGGGGGGGGGGGGGGGGW",
"GGGGGGGGGGGGGGGGGGGW",
"GGGGGGGGGGGGGGGGGGGW",
"GGGGGGGGGGGGGGGGGGGW",
"GGGGGGGGGGGGGGGGGGGW",
"GGGGGGGGGGGGGGGGGGGW",
"GGGGGGGGGGGGGGGGGGGW",
"GGGGGGGGGGGGGGGGGGGW",
"GGGGGGGGGGGGGGGGGGGW",
"GGGGGGGGGGGGGGGGGGGW",
"GGGGGGGGGGGGGGGGGGGW",
"GGGGGGGGGGGGGGGGGGGW"
]
}